18 24 150
========================
=         ==@==        =
=      I  =*#*=  E   M =
=  T      =***=    X   =
=    X    =*#*= ^      =
=         =!!!=        =
===========###=   ======
=                      =
=    I                 =
=***      ^       ***  =
=*!*              *!*  =
=***              ***  =
=     ^        =       =
=====      D   =    X  =
=   #          =       =
= K =  X       = ^ W   =
=   =       F  =       =
========================