15 20 120
====================
=W    E         *#K=
=  X  F  ^  X   *##=
=             I ***=
=       =====      =
=****   =!*!=      =
=       =*@*=   F  =
=     D =!*!=      =
=       =*#*=   !!!=
= ^                =
=                  =
=   X      *  ^  D =
=!!    ^   *    X  =
=T!    I   *      M=
====================